NO            textures/eagle.xpm
SO textures/greystone.xpm
WE textures/wall.xpm






F 128, 128, 128
EA textures/wall.xpm
C     100, 149, 237

1111111111111111111111111111111
1000000000000000000000000000001
1000000000000000000000000000001
1000000000W00000000000000000001
1000000000000000000000000000001
1000000000000000000011100000001
1000000000000000000000000000001
1111111111111111111111111111111
