NO            textures/stone.xpm
SO textures/halloween.xpm
WE textures/oldwall.xpm






F 59,42,30
EA textures/spider.xpm
C     47, 65, 90



                                 111111111111111
                                 1D0000000000001
        111111111111111111111111111000000000001 
        1000000000110000000000001000000000000001
        1011000001110000000000001D100000000000001111111111111111
        100100000000000000000000DD1111111111110000000000011111
11111111101100000111000000000000111         11000000000001                
10000000001100000111d11111111111            1111100001111111    
1111011111111101110000001000111111111111111 110000000000001      
11110111111111011101010000000D0000000000001 110000000000001
1100000011010101110000001CC00100000000000001100000000000001      
10000000000000001100000010001000000000000011D10000000000001111111111111111111111111111 
100000000000000011010100100011000000000000DDD111111111111111111000000000000000000011  
11000001110101011111011110N0011111111D11111111            11000000CCCCCCCCCCCCCCC0011 
11110111 1110101 1011110100C1       101                    1100000CCCCCCCCCCCCCC00001    
11111111 1111111 111111111111       101                    1000000CCCCCCCCCCCCCC00001     
                                    101                     100000CCCCCCCCCCC00010001          
                                    101                     1000000000CCCCCCCCCC0001111
                                    101                     10000000000CCCCCCCCCCC0D0001          
                                    101                     1111111101111111111111111111
                                    1011111111111111111111111111111101
                                    1000000000000000000000000000000001
                                    1111111111111111111111111111111111