111111
10C001
1C0E01
10P1E1
101C01
111111