111111111111111111111111111
1P0000000000000000000000001
111101111011101111101111011
10010000100000001V00001V001
1V11111V1111011101110111111
10000001C00000001C000000001
111101110101111111011111011
100000000001C001V10000C0001
110111011111010111000000011
1001V0000000C001C0000000111
100111011101010E11111C111V1
111111111111111111111111111