1111111111111111
1P10000000000001
1010111111111101
1010111001100101
10100000E0000101
1001111101111001
1CCCCCCCCCCCCCC1
1111111111111111